***********
*         *
* ***** ***
*  T* *   *
***** *** *
*   * *   *
* *     * *
* * ***** *
* * *   * *
* *   *S* *
***********