***********************************************
*     *         * * * *S    *   *             *
* ***** ******* * * * * *** * * * ***** ***** *
* *           * *     *   * * * * *   *   * * *
* * ********* * ***** * * * * *** * * ***** * *
* * *         *       * * *       * *       * *
* * ******************* *********** ********* *
* * *             *   *           * *         *
* * ************* * *** ********* * * * *******
* * *   *   *   *       *       * * * * *     *
* * * * * * * * *** ***** ***** * * * * * *** *
* * * *   *   *   *       *   * * * * * * *   *
* * *** ********* *********** * * * * * * * ***
*   *   * *     *       *     * * * * * * *   *
* *** * * * *********** * * * *** * *** * *** *
*     *   *           * * * *   * *   * * *   *
********************* * * * *** * * * * * * ***
*                   * * * *   * * * * * * * * *
* ******* ******* * * * * * *** * * * * * * * *
* *             * * * *   * *   * * * * * * * *
* * *********** * *** ***** * *** *** * * * * *
* * *         * * *         *         * * *   *
* * * ******* * * * ***************** * ***** *
* * *   *   * * * * *               * * *     *
* ***** * * * * * * *********** *** *** * *****
*   *   * * * * * *     *     *   *   * *   * *
*** * *** *** * * * *** * ******* *** * *** * *
* * *   *   * * * * * * *       *   * *     * *
* * *** *** * * * * * * ******* *** ********* *
* *       * * * * *   * *     *   *       *   *
* ********* * * * ***** * * * *** ******* * * *
*         * * * *       * * *     *   * * * * *
* ******* * * * ********* * ******* * * * * * *
* *     * * * * *     * * * *       *   * * * *
* * *** * * * * * *** * * * * *********** * * *
* * *   * * * * *   * * * *   *           * * *
* * * *** * * ******* * * ***** *********** * *
* * * * *     *       *   *       *     *   * *
* * * * ************* * * * ***** * *** ***** *
* * * *   *           * * * *     *   * *     *
* * * *** * ************* * ***** *** * * *** *
* * *     *         *     * *         * * *   *
* * *************** * ***** *********** * * ***
*             *   * * *               * * *   *
* ******* *** * *** * ***************** ***** *
*T*         *                                 *
***********************************************